WWWWWWWWWW
W        W
W   $    W
W        W
W        W
WWWWWWWWWW
